шшшшшшшшшшшшшшшшшшшшшшшшшшшшшшшшшшшшшшшшшшшшшшшшшшшшшшшшшшшшшшшшшшшшшш
шйннннннннннннннннннйнннннннннннннннннннннннннннннннннннннйнннннйннннш
ш лнннннннннннннннн╧ лннннннннннннннннннннннннннннннннннн╧ лннн╧ лнннш
шкннннннннннннннннннкнннннннннннннннннннннннннннннннннннннкнннннкннннш
шнннннннннннннннннннннннннннннннннннннннннннннннннйннннннннннннннннннш
шнннннннннннннннннннннннннннннннннннннннннннннннн╧ лнннннннннннннннннш
шнннннннннннннннннннннннннннннйнннннннннннннннннннкнйннннннннннннннннш
шнннннннйнннннннннннйнннннннн╧ лннннннннннннйнннннн╧ хнннннннннннннннш
шнннннн╧ лнййнннннн╧ лннннннннкнннннннннннн╧ лнннннн╩ лнннйннннннннннш
шнннннннкн╧  лннннннкнннннннннннннннннннннйнкннннннннкннн╧ лнннннннннш
шннннннннннккнннннннннннннннннннннннннннн╧ лннннннннннннннкннннннннннш
шннннннннннннйннннннннннннннннннннннннннннкннннннннннннйййнннннннннннш
шннннннннннн╧ лннннннйнннннннннннннннннннннннннннннннн╧   лннннннннннш
шнннйннннннннкнннннн╧ лнннннннннннннннннйннннннннннннннк╩ хннннннннннш
шнн╧ лнннннннннннннннкннннннннннннннннн╧ лнннннннннннннн╧  лнннннннннш
шнннкйнйннннннннннннннннннннннйнннннннннкнннннннннннннннн╩ лнннннннннш
шннн╧ ╨ лнннннннннннннннннннн╧ лннннннннннннннннннннннннн╧ лнннннннннш
шннннкнкнннннннннйннннннннннннкнннннннннннннннннннннннннн╪ лнннннннннш
шннннннннннннннн╧ лннннннннннннннннннннннннннннйнннннннн╧  лнйййййнннш
шннннннннйнннннннкнннннннннннннннннннннннннннн╧ лннннннн╧ ин╪     лннш
шннннннн╧ лннннннннннннннннннйнннйнннннннннннннкнннннннн╧ л╧  ик╣ лннш
шннннннннкнннннннннннннннннн╧ лн╧ лнннннннннннйннннннннн╧ х╪ ий╪  лннш
шнннннннннннннннйннннннннннннкнннкнннннннйннн╧ лнннннннн╧    п   фйннш
шнннннннннннннн╧ лнннннннннннннннннннннн╧ лнннкннннннннннккм╣  и╩  хнш
шнннннннннннннннкннннннннннннннннннннннннкнннннннннннйнннн╧   инн╩  хш
шннннннннннннннннннннйнннннннннннннннннннннннннннннн╧ лннн╪ икннйй╣  ш
шннннннннннннннннннн╧ хнннйннннннннннннннннннннннннннкннн╧  лнн╪   р ш
шнннннннннннннннннннн╣ лн╧ лнйнннннннннннннннннннннннннйн╧ фйй╪  ╟ ╨ ш
шннннннннннннннннннн╧ инннкн╧ лннннннннннннннннннннннн╪ л╧      р  ╨ ш
шннннннннннннннннйнннкнннннннкннннннннннннннннннннннн╧ иннкккккк╧ ф╧ ш
шннннннннннннннн╧ лнннннннннннннннннннннннннннннннннннкннннннннн╧  п ш
шннннннннннннннннкннннннннннннннннннннннннннннннннннннннннйнннннн╩   ш
шнннннннннннннннннннннйннннннннннннйнннннннйннннннннннннн╧ лнйннннкккш
шнннннннннннннннннннн╧ лнннннннннй╧ лннннн╧ лнннннннннннннкн╧ лннннйнш
шнннннннннннннннннннннкнннннйннн╧ лкнннннннкнннннннннннннннннкнннн╧ лш
шнннннннннннннннннннннннннн╧ лнннкннннннннннннннннннйннннннннннннннкнш
шнннннннннннннннннннннннннннкннннннннннннннннйннннн╧ лнннннннннннннннш
шннннннннннннннннннннннннннннннннннннннннннн╧ лнннн╧ лнннннннннннннннш
шннннннннннннннннннннннннннннннннннннннннннннкннннннкннннннннннннннннш
шшшшшшшшшшшшшшшшшшшшшшшшшшшшшшшшшшшшшшшшшшшшшшшшшшшшшшшшшшшшшшшшшшшшшш
